#################################################
#     #       #     #       #   #       #     B#
# ### ### ### ### ### ##### ### ### ### ### ### #
# #   #     #   #   #   #     #     #   #     # #
# # # # ### ### # ### ### ######### ### ##### # #
# # # #     #   #     #       #     #     #   # #
# # ####### # ######### ##### # ##### ### # ### #
# #         #       #   #   #   #   #   # #   # #
# ########### ### # ### ### ### # # ### ### ### #
# #   #     #   # #   #     #   # #   #   #     #
# # # # ### ### ##### ##### ### # ### # ####### #
# # #   #   #     #     #     # #   # #       # #
# # ##### ######### ### ### ### ### # ##### # # #
# #       #         #   #     #     #     # #   #
# ######### ########### ####### ######### #######
#       #   #       #   #     #   #       #     #
####### # # # ##### # ### ### ### ### ##### ### #
#     # # #   #     #     #     #   #   #     # #
# ### # # ##### ########### ##### ### ####### # #
#   # #     #       #     #     #     #     #   #
### # ##### # ##### # ### ### ### ##### ### #####
#   #     # #   #   #   # #   #       #   #     #
# ####### # ### # ### # # ### ### ### # # ##### #
#       # #     #     # #   #         #     #   #
# ##### # ############### ####### # ##### # # ###
#   #   #       #     #           #     # # #   #
### # ######### # ### ##### # ######### # ### # #
#   #     #     # #   #     # #     #   #   # # #
# ####### # ##### ### # ##### # ### # ##### # # #
#         #         #         #     #       # A #
#################################################
