#########################
#   #       #     #     #
# # # ##### ### ### ### #
# #     #   #     #   # #
# ##### # ##### ### # # #
#     #   #   #   # #   #
### # ### # # ### # #####
#   #     # #   # #     #
# ##### ### ### ### ### #
#     #     #     # #   #
# ### ##### ##### # # # #
#   #     #     # #   # #
##### ### ### # ##### ###
#   #   #     #     #   #
# ### ####### ##### ### #
# #       #       #     #
# ####### # ### ####### #
#       # # #   #       #
### ### # # # ### ##### #
#     #   # #   #   #   #
# ### ##### ### ### # ###
#   #         #     #  B#
##### ######### ####### #
#A                  #   #
#########################
