#############################
#     #     #       #     B#
### # ### # # ##### ### # ##
#   #     # #     #     #  #
# ##### ### ##### ##### ####
#     #     #   #     #    #
##### # ##### ### ### ######
#   # #     #     # #      #
# # ### ### ##### # # #### #
# #     #   #     # #    # #
# ##### # ### ####### ## # #
#     # #   #       #  # # #
##### # ##### ##### # ## # #
#   #       #     # #    # #
# # ######### ### # #### # #
# #         #   # #      # #
# ########### # ####### ## #
#           # #       #    #
### ####### # ##### # ######
#   #     # #     # #      #
# ### ### # ### ### ###### #
#   # #   #   #   #      # #
# # # # ##### # ####### # ##
# #   #     # #       # #  #
# ####### # ### ##### # ## #
#         #     #   #     A#
#############################

